%%%%%%%%%%%%%%%
% %% %% %%  %P%
% %         %%%
%%  % % %%%%% %
%     %   %%%%%
%%%%%%%    % %%
%%%%%% %% %%% %
%%%% %% %%% %%%
%.% %%%%%%  %%%
%%%%%%%%%%%%%%%
