%%%%%%%%%%%%%%%
%    %  %%   P%
%             %
%   %         %
%         %  %%
%  %%        %%
%%  %  %      %
%    %  %     %
%.  %%%%%   % %
%%%%%%%%%%%%%%%
