%%%%%%%%%%
%%      P%
%% %     %
% %%     %
%   % %% %
%  %     %
% %      %
%        %
%.       %
%%%%%%%%%%
