%%%%%%%%%%%%%%%%%%%%%%%%%%%%%%%%%%%%%%%%%%%%%%%%%%%%%%%%%%%%%%%%%%%%%%%%%%%%%%%%%%%%%%%%%%%%%%%%
%           %                  %  %  %%        %%  %  %          %  %        %%%%%   %     %  P%
% %    %   %%    % %            % %%  %          %  %         %%%%%       %    %   %       %   %
%         %       %%       %      %   %  %           %              %    %     %  % %  %%    % %
%% %     %                          %    %%         %  %                              % %   %  %
%   % % %    %          %% %%    %       %%              %             %%%%   %     %      % % %
%          %          %%     %     %      %%% %  %      %    %        %     %  %               %
% %%        %   %%      %  % %  %   % % %           %           %% %       %    %%      %   % %%
%     %     % %% %      %% %  %           %    %% %  %    %   %     %   %%% %    %   %         %
%   %  %                  %   %    % %               %%   %        %                 %%%       %
%                              %    %       %  %%%             %       %%%%  %      %     %%   %
%            % %  %  %   %    % %  %  %       %  %          %   % %  %%%%   %   %  % %        %%
%  %   %       %   %           %%         %%   %    %         % %   %      %  %        % %%%   %
%  %           %%%    %%    %                  %             %  %        %          %        % %
% %  %  %%    % %      %         %            %   %   %          %                  %%   %  %  %
%     % %              %          %  %   %% %  %%          %% %     %          %         %    %%
% %  % %  %      % % %     %           %  %    %           %%%    %      %    %                %
%  % %   %        %      %%%%   % %%   % %% % %           %          %   %  %     %       %   %%
%       %        %%  %%       %      %  %  % %  %        % %   %        %  %       %%%         %
%           %    % %  %      %    % % % %  %%         %    % %%  %   % %     % %               %
%  %  %    %  %  %   %  %%               % % %  %   % %%             %       %  %   %         %%
%    %         %        %%   %%                 %       %%%   %  %           %  %   % %     %  %
%%  % %   %   %         %     %%  %  %     % % %%    % %        %    %   %        %   %     %  %
%  %%%%       %   %    %                          %%     %% % %    % % % % % %                 %
%    %    %    %   %       %%          %     %              % %       %%     % %          %%   %
%      %                   %    %%   %       %%% %           % %        %%           % %       %
%  %      %       %    % %  %  %%           %       %   %  % %      %  %% %%%%  %    %% % % % %%
%% %            %      %  %  %        % %  %   %             %  % %%   %     %%           %% % %
% %   %   %             %  %     % %%         % %  %   % % % %    %   %        %    %    %% %  %
%% %%   %   %           %         %%        %  %   %    %                                 %  % %
% %  %    %   %%      %%%     %        %   %            %      %        %        %      %      %
%% % %       %  % %   % %     %      %  %   % %        %       %      %    %% %           %%   %
%%  %                   %%   %% %  % %           % %                 %    %%    %%%%%          %
%%       %    %       %  %   %  %%%%     %%     % %% % % % %% %%  %% %   %   %        %  %  %% %
%%         %%       %   %%    %     %  %          %         %     %%%                 %    %   %
%  %%       %%  %     %%    %   %%              %%%                    %  %                %   %
%   %     %  %  % %        % %     %     %                     %   %    %           %      % % %
%  %  %%    %%  %        %       %        % % %%      %          %      % %%%   %       %      %
%    % %%        % %    %%         % %                   %       %%    % %       %   % %% %    %
%       %         %   %        %    % %%%                %              %  %  %   % % % % %    %
%%   %   %  %       %%     %           %          %   %         %     % %  %    %%%   %%   %% %%
%          % %%   %% %%     %      %  %    %  %%   %   %    %%  %  % %%  % %     %   %    %    %
%   %        % %    %   %      %         %%% %           %  % %    % %%%  %        %  %%      %%
%    %%%        %       %     %   %    %% %    %    %     %          %  % %  %    %      %% %  %
%    %%  %  %%          %        %             % %                %          %%   %  %    %%  %%
%% % % %       %  % %           % % % %   %%   %  %   %    %  %       %      %             %   %
%       %               %%  %                    %           % %    %% % %       % %    %    %%%
%   %   %  %     %   %  %        %   %%   %   %            %   %%%   % %    %  %            % %%
% %              %%  %    % %%%  %   %    %      % %    % %%  % %    %                    %  %%%
%%   %%    %       %                       %                %     %    %    %     %%  %   %    %
%        %%  %%  %   %                     %   % %%           %% %%    %%  %%%%           % %  %
%% %   %   %    %          %   %             %        %        % %    %   %  %% %       %% %  %%
% % %                      %         %      %                %   %         %    %%   %% %     %%
%      %    %%        % %                      %      %         %        %%    %   %%  % %     %
%% %  %         %  %    %     %  % % %    %    % %        %  %  %      %                %      %
%        %      %  %  %%         %   %  %        %%      % %    %    %   %     % % %           %
%                         %    %              %   %   %   %% %    %%%      %               % % %
%  %  %   %          % %    %%    %%        %%    %    % %%                            %   %%  %
%       % %    %      %  %     % %               %   %             %  %%%  %  %           % %  %
%%  %         %%   %  %     %        %%%  %%  %      %   %   %   %   % %     % %               %
% %     %% %     %  % % %  %    % %    %  %   %   %%   % %  % %   %           % %   %      % % %
%       %  %         %   %   %%% %%     %     %             %              %      %        %  %%
%  %     %           %%   %    %  %       %     %         %         % %%%        % %   %% % %  %
%    %         %%   %  %   %         %% %% %    % % %%%    %             %     %              %%
% %      %    %          %     %                   %  %   %%                              %    %
%%%        %              %            %  %          %  %      % % %%      %%%  %  %% %%   %%  %
% %     %  %   %  %        %    % %%  %             %     %  %   %         %   %%%% % % %      %
%   % %     %  %%%  %             %     %    %   %             %% %  %  % %       %%      % %  %
%   %%   %   % %    %    %       %     %%         %     %   %    %    %       %%   %     %     %
%    %     %%  %           % % %                       %%%%    %%%  %   %%%%     %%%%%      %  %
%   %%      %%  %%         %  %  %        %  %      %   %  %                 %             %   %
%    %%          %  %      %      %      %       %%        %   %  %   %   % %       %  % %%  % %
% %         %                      %   %     %  %% %%     %         %    %    %        %%    %%%
%     %% % %                %      %         %                  %      % %  %%    %       %    %
% %  %       %                             %     %  %% %%%   %    %   %       %  % % % %       %
%% %%   %  %%       %        %  %%   % %       % %    %       %          %  %  %   %%    %     %
%%    %%%   % %  % % %%       %  %   %   %%%     %      %        %   %        % %             %%
%    %  %      %    %  % %                  %     %    %%%%  %    %    %  %  %         %     %%%
%%            %%   %       %   %%%%   % %%%  %               %   %     %  % % %      %%    %   %
%           %          %   %     %     %  %   % %          % %       %%%         %      %      %
%      %         %%             % % %      % % %     %%%%       %%%                 %   %    % %
% % %   %      %            %%   %     %      %%        %          %%    % %%     %       %    %
%      %  % %              %     %%   %             %      %            %  %  %%%   %          %
%         %      %             %   %       % %   %   %    %% %       %       % %        %%     %
%%  %   %%   %%  %%                       %    %      %   %%%    %   %  %       %         %    %
% %  %%% %          %    %         %%%    %     %    %       %   %   %      %         %%  %    %
%%   %     %  %    %%      %% %     %          %   %   %    % %   %  % %        %    % %%%   % %
% %          %%          % %        %   %  % %     %  %   %   % %           %   %      %%    % %
%% %  %      %%%    % %            %     %   %  %       %    %        %      %        %   %    %
%               %      %                %     %   %% % %  % %%%%%      %     %           %% % %%
%        %%    %         %         %         %        %%   %   %                     % %   %   %
%                %     %% %         %      %         % %     %  %                 %       %   %%
%   %%      % % %    %%     %      %  %  %              %%   % % %  %          %     %   %     %
%% %            %     % %%%%          % %%      %%     %%%    % %  %     %    % %   %  %%     %%
%         % %         % %      %     %       %   %    %% %     % %    %     %%           %  %% %
%  %            %    %  %  %%%%   %         %  % %  %   %%           %  %   % %                %
%.%  %%         %%     %       %     %  % %                   %      %% %                  %   %
%%%%%%%%%%%%%%%%%%%%%%%%%%%%%%%%%%%%%%%%%%%%%%%%%%%%%%%%%%%%%%%%%%%%%%%%%%%%%%%%%%%%%%%%%%%%%%%%
